~~~~~~~~~~~~~~~~~~~~~~~~~~~~~~~~~~~~~~~~~~~~~~~~~~~~~~~~~~~~~~~~
~~~~~~~~~~~~~~~~~~~XX~~~~~~~~~~~~~~~~~~~~~~~~~~~XXX~~~~~~~~~~~~~
~~~~~~MX~~~~XX~~~~XXXXXXXX~~~~~XXXXXX~~XXXX~~~~XXXXX~~~~XXXXXX~~
~~~~~XXX~~~~XXX~~~XXXXXXXXX~~XXXXXXXXXXXXXX~~~~XXXXX~~~XXXXXXX~~
~~~~XXXX~~~~XXXXXXXXXXXXXXXXXXXXXXXXXXXXXXX~~~~~XXXX~~~~XXXXXX~~
~~~~XXXX~~~~~XXXXXX~~XXXXXXXXXXXXXXXXXXXXXX~~~~XXXXXX~~~XXXXXX~~
~~~XXXXX~~~~~XXXXX~~~XXXXXXXXXXXXXXXXXXXXXXXXXXXXXXXXXXXXXXXXX~~
~~XXXXXX~~~~XXXXXXXXXXXXXXXXXXXXXXXXXXXXXXXXXXXXXXXXXXXXXXXXXX~~
~~XXXXX~~~~XXXXXXXXXXXXXXXXXXXXXXXXXXXXX~~~~XXXXXXXXXXXXXXXXXX~~
~~XXXX~~~~~XXXXXXXXXXX~XXXXXXXXXXXXXXXX~~~~~~XXXXXXXXXXXXXXXXX~~
~XXXX~~~~~XXXXXXXXXXX~~~XXXXXXXXXXXXXXXX~~~~~~~XXXXXXXXXXXXXXX~~
~XXX~~~~~XXXXXXXXXX~~~~XXXXXXXXXXXXXXXXXXXXXXX~~~~~~XXXXXXXXXX~~
~XXX~~XXXXXXXXXXXXX~~XXXXXXXXXXXXXXXXXXXXXXXXXX~~~~~~~XXXXXXXX~~
~XXXXXXXXXXXXXXXXX~~XXXXXXXXXXXXXXXXXXXXXXXXXXXXX~~~~~~~~XXXXX~~
~XXXXXXXXXXXXXXXX~~XXXXXXXXXXXXXXXX~~~XXXXXXXXXXXX~~~~~~~~XXXXX~
~XXXXXXXXXXXXXXXX~~XXXXXXXXXXXXXXXX~~~XXXXXXXXXXXXXX~~~~~~~XXXX~
~~XXXXXXXXXXXXXX~~~XXXXXXXXXXXXXXXXXX~XXXXXXXXXXXXXXX~~~~~XXXXX~
~~XXXXX~XXXXXXX~~~~XXXXXXXXXXXXXXXXXXXXXXXX~XXXXXXXXXX~~~XXXXXX~
~~XXXXX~XXXXXXX~~~~XX~~~XXX~XXXXXXXXXXXXX~~~~XXXXXXXXX~~XXXXXX~~
~~XXXXXXXXXXXXX~~~XX~~~XXX~~~XOXXX~~XXXX~~~~XXXXXXXXXXXXXXXXXX~~
~~XXXXXXXXXXXXXXXXXXX~XXX~~~~XXXX~~~~~~~~~~~XXXXXXXXXXXXXXXXXXX~
~~XXXXXXXXXXXXXXXXXXXXXXX~~~XXXXX~~~~~~~~~~XXXXXXXXXXXXXXXXXXXX~
~~XXXXXXXXXXXXXXXXXXXXXX~~~XXXXXX~~~~X~~~~~XXXXXXXXXXXXXXXXXXXX~
~~XXXXXXXXXXXXXXXXXXXXXX~~~XXXXXX~~~XXX~~~XXXXXXXXXXXXXXXXXXXXX~
~~XXXXXXXXXXXXXXXXXXXXXX~~~XXXXXXX~XXXX~~~~XXXXXXXXXXXXXXXXXXX~~
~~XXXXXXXXXXXXXXXXXXXXX~~~~XXXXXXXXXXXX~~~XXXXXXXXXXXXXXXXXXXX~~
~~XXXXXXXXXXXXXXXX~XXXX~~~~XXXXXXXXXXXXX~~XXXXXXXXXXXXXX~XXXXX~~
~XXXXXXXXXXXXXXXXX~XXXXX~~~XXXXXXXXXXXXXXXXXXXXXXX~~XXX~~~XXXX~~
~XXXXXXXXXXXXXXXXX~XXXXXXXXXXXXXXXXXXXXXXXXXXXXXX~~~~XXX~XXXXX~~
~XXXXXXXXXXX~~XXXXXXXXXXXXXXXXXXXXXXX~XXXXXXXXXXXX~~XXXXXXXXXX~~
~XXXXXXXX~~~~~~XXXXXXXXXXXXXXXXXXXXX~~~XXXXXXXXXXXXXXXXXXXXXXX~~
~XXXXXXXX~~~~~~XXXXXXXXXXXXXXXXXXXXXX~XXXXXXXXXXXXXXXXXXXXXXXX~~
~XXXXXXX~~~~~~~XXXXXXXXXXXXXXXXXXXXXXXXXXXXXXXXXXXXXXXXXXXXX~~~~
~~XX~~~~~~~~~~~~~~XXXX~~~~XXXXXX~~~XXXXXXXXXXX~~XXXXXXXXXX~~~~~~
~~~~~~~~~~~~~~~~~~~~~~~~~~~~~~~~~~~~~~~~~XX~~~~~~~XXV~~~~~~~~~~~
~~~~~~~~~~~~~~~~~~~~~~~~~~~~~~~~~~~~~~~~~~~~~~~~~~~~~~~~~~~~~~~~
